                                                                 
=========================-=======================================
==============----------@-=======================================
=========------==================================================
======-----======================================================
=====--==========================================================
====--====#######################################================
===--====##.............................#.......##===============
==--=====#.......................................#===============
==--=====#..............................#........#$==============
==---====#....##..##..##..##..##..##..######..##########=========
===--====#.............................................###=======
====-----/...............................................##======
======---/...............................................##======
=========#.............................................###=======
=========#....##..##..##..##..##..##..######..##########=========
=========#..............................#........#======+========
=========#.......................................#=========+=====
=========##.............................#.......##===+===========
==========#######################################========+===+===
=======================================+=========+===============
=================================+===+======+=========+===+======
===============================+==================+=========+====
===================================+===========+=======+=========
=======================================+=====================+===
=================================================================
                                                                 

{
	"level": "Game.Level.Chapel",

	"#": {
		"cell": "stonewall"
	},
	".": {
		"cell": "floor"
	},
	"-": {
		"cell": "path"
	},
	"=": {
		"cell": "grass"
	},
	"@": {
		"cell": {
			"type": "path",
			"id": "start"
		}
	},
	"+": {
		"cell": "tombstone"
	},
	"/": {
		"cell": {
			"type": "door",
			"closed": 0
		}
	},
	"$": {
		"cell": "grass",
		"item": "gold"
	}
}
